10
10
32
955555555C
A        A
A        A
A        A
A   0    A
A        A
A        A
A  0     A
A        A
3555555556