24
24
32
111111111111111111111111
122222000000000000000001
121112111011010111011101
121222001010010100000101
121210101000010101010101
121210101010000101010101
121210001010010100010101
121222111010110111000101
121112222222222200011101
122222001110011100000001
111101101000000101101111
000000001000000100000000
111101101111111101101111
100000000000000000000001
101011001101101100110101
101010000100001000010101
101000110001100011000101
101000110001100011000101
101010000100001000010101
101011001101101100110101
101000000001100000000101
101111111101101111111101
100000000000000000000001
111111111111111111111111
