24
24
32
000000000000000000000000
011111111111111111111110
010001000100101000100010
010111110101101011111010
010101010111101010101010
010101010101111010101010
010101110101101011101010
010111000101001000111010
010001111111111111100010
011111110001100011111110
000010010111111010010000
111111110111111011111111
000010010000000010010000
011111111111111111111110
010100110010010011001010
010101111011110111101010
010111001110011100111010
010111001110011100111010
010101111011110111101010
010100110010010011001010
010111111110011111111010
010000000010010000000010
011111111111111111111110
000000000000000000000000
